1 0 0 0 1 S
1 0 1 1 1 1
1 1 1 1 1 1
1 0 1 0 0 1
1 0 1 0 1 1
F 1 1 1 1 1  