1 1 1 1 0 1
S F 0 1 1 1
1 1 1 1 1 0
0 0 1 1 0 0
0 0 0 0 0 0
1 0 1 0 1 0  